16
31
06 00 00 00 00 00 00 00 00 00 00 00 00 00 00 00 00 04 06 00 00 00 04 05 09 09 09 09 09 09 05
06 19 00 00 00 00 00 00 00 22 00 00 00 00 00 00 00 04 06 00 00 00 04 06 00 00 00 00 00 00 04
06 00 00 00 00 00 00 00 13 14 15 00 00 00 00 00 00 04 06 00 00 00 04 06 00 00 00 19 00 00 04
06 00 00 00 24 20 00 00 00 00 00 00 00 00 00 00 00 04 06 00 00 00 12 16 00 00 00 00 00 00 04
10 11 02 02 02 03 00 00 00 00 00 00 00 00 19 00 00 04 06 00 00 00 20 00 00 00 22 00 00 00 04
05 09 09 09 09 16 00 00 00 00 00 00 00 00 00 00 00 04 06 00 00 00 01 02 02 02 02 02 02 07 08
06 00 00 00 00 00 00 00 00 21 24 00 00 00 00 00 00 04 06 00 00 00 04 05 05 05 05 05 05 05 05
06 00 00 00 00 00 00 00 13 14 15 00 00 01 02 02 07 08 06 00 00 00 04 05 05 05 05 05 05 05 05
06 00 00 00 00 00 00 00 00 00 00 00 00 12 09 09 09 09 16 00 00 00 04 05 05 05 05 05 05 05 05
06 00 00 00 00 19 00 00 00 00 00 00 00 00 00 00 00 00 00 00 00 00 04 05 05 05 05 05 05 05 05
06 00 23 00 00 00 00 00 00 00 00 00 00 24 20 00 00 00 00 19 00 00 04 05 05 05 05 05 05 05 05
06 24 00 00 00 00 00 00 20 00 00 00 00 13 15 00 00 00 00 00 00 00 04 05 05 05 05 05 05 05 05
10 11 02 02 02 02 02 02 03 00 00 00 00 22 00 00 00 00 00 00 00 00 04 05 05 05 05 05 05 05 05
05 05 05 05 05 05 05 05 06 00 00 01 02 02 02 02 02 02 02 02 02 07 08 05 05 05 05 05 05 05 05
05 05 05 05 05 05 05 05 05 17 17 05 05 05 05 05 05 05 05 05 05 05 05 05 05 05 05 05 05 05 05
05 05 05 05 05 05 05 05 05 18 18 05 05 05 05 05 05 05 05 05 05 05 05 05 05 05 05 05 05 05 05